###############
#@            #
 ######### $###
        #   #
     ###*   #
     ########