###############
#@            #
#      $      #
#             #
#        *    #
###############