###############
#@            #
#    $        #
###         ###
  #      ####
  #   *  #
  ########